#######################################
# Syntax Coloring Map for AceTime library
#######################################

#######################################
# Datatypes (KEYWORD1)
#######################################

DateTime	KEYWORD1
TimeZone	KEYWORD1
TimePeriod	KEYWORD1
TimeProvider	KEYWORD1
TimeKeeper	KEYWORD1
DS3231TimeKeeper	KEYWORD1
NtpTimeProvider	KEYWORD1
SystemTimeKeeper	KEYWORD1
SystemTimeSyncCoroutine	KEYWORD1
SystemTimeHeartbeatCoroutine	KEYWORD1
SystemTimeLoop	KEYWORD1

#######################################
# Methods and Functions (KEYWORD2)
#######################################

# DateTime.h
isError	KEYWORD2
setError	KEYWORD2
year	KEYWORD2
yearFull	KEYWORD2
month	KEYWORD2
day	KEYWORD2
hour	KEYWORD2
minute	KEYWORD2
second	KEYWORD2
dayOfWeek	KEYWORD2
timeZone	KEYWORD2
convertToTimeZone	KEYWORD2
printTo	KEYWORD2
incrementYear	KEYWORD2
incrementMonth	KEYWORD2
incrementDay	KEYWORD2
incrementHour	KEYWORD2
incrementMinute	KEYWORD2
toDaysSinceEpoch	KEYWORD2
toSecondsSinceEpoch	KEYWORD2
toUnixSeconds	KEYWORD2
compareTo	KEYWORD2

# TimeZone.h
forHour	KEYWORD2
forHourMinute	KEYWORD2
forOffsetString	KEYWORD2
tzCode	KEYWORD2
effectiveTzCode	KEYWORD2
toMinutes	KEYWORD2
isDst	KEYWORD2
asStandardMinuteOffset	KEYWORD2
asStandardSecondOffset	KEYWORD2
asEffectiveMinuteOffset	KEYWORD2
asEffectiveSecondOffset	KEYWORD2
incrementHour	KEYWORD2
increment15Minutes	KEYWORD2
extractStandardHourMinute	KEYWORD2
extractEffectiveHourMinute	KEYWORD2
setError	KEYWORD2
isError	KEYWORD2
printEffectiveOffsetTo	KEYWORD2
printTo	KEYWORD2

# TimePeriod.h
hour	KEYWORD2
minute	KEYWORD2
second	KEYWORD2
sign	KEYWORD2
printTo	KEYWORD2
toSeconds	KEYWORD2
negate	KEYWORD2
incrementHour	KEYWORD2
incrementMinute	KEYWORD2
compareTo	KEYWORD2

# TimeProvider.h
setup	KEYWORD2
getNow	KEYWORD2
sendRequest	KEYWORD2
isResponseReady	KEYWORD2
readResponse	KEYWORD2

# TimeKeeper.h
setNow	KEYWORD2

# SystemTimeKeeper.h
getLastSyncTime	KEYWORD2

#######################################
# Instances (KEYWORD2)
#######################################

#######################################
# Constants (LITERAL1)
#######################################

# DateTime.h
kSecondsSinceUnixEpoch	LITERAL1
kDaysSinceJulianEpoch	LITERAL1
kEpochYear	LITERAL1

# NtpTimeProvider.h
kNtpServerName	LITERAL1
kLocalPort	LITERAL1
kRequestTimeout	LITERAL1
